Glaciaxion	Glaciaxion
Eradication Catastrophe	Eradication Catastrophe
Credits	Credits
Dlyrotz	Dlyrotz
Engine x Start!! (melody mix)	Engine x Start!! (melody mix)
¹â	¹â
Winter ¡ücube¡ý	Winter ¡ücube¡ý
Cipher : /2&//<|0	Cipher1
»ìÂÒ-Confusion	»ìÂÒ
FULi AUTO SHOOTER	¸£Àû×Ô¶¯Éä
HumaN	HumaN
[PRAW]	praw
Pixel Rebelz1	Æ¤¿ËË¹1
Pixel Rebelz2	Æ¤¿ËË¹2
Pixel Rebelz3	Æ¤¿ËË¹3
Cereris1	cereris1
Cereris2	cereris2
Cereris3	cereris3
Non-Melodic Ragez (MUG Edit)	ÄãÂîÈË
Sultan Rage	ËÕµ¤
Class Memories	ÉÏ¿Î¼ÇÒä
-SURREALISM-	³¬ÏÖÊµ
Bonus Time	¶îÍâÊ±¼ä
Energy Synergy Matrix1	ESM1
Energy Synergy Matrix2	ESM2
Energy Synergy Matrix3	ESM3
Doppelganger1	Doppe1
Doppelganger2	Doppe2
¤â¤Ú¤â¤Ú1	ÏÈÉúÂòÒ»¶ä°É
¤â¤Ú¤â¤Ú2	»¨»¨
MARENOL	ÂîÈËol
Ó©»ð³æ¤ÎÔ¹1	Ó©»ð³æ1
Ó©»ð³æ¤ÎÔ¹2	Ó©»ð³æ2
Íò¶ÖÄäÃûÐÅ	ÄäÃûÐÅ
·çÓì	fengyv
Aphasia	Aphasia
ÈAµÆ°®1	»ªµÆ°®1
ÈAµÆ°®2	»ªµÆ°®2
dB doll	dB-doll
Dash	Dash
ÔÆÅ®º¢	ÔÆÅ®º¢
Drop It	Drop it
RIPPER	ripper
¿ªÐÄ²¡1	¿ªÐÄ²¡1
¿ªÐÄ²¡2	¿ªÐÄ²¡2
Introduction	Introduction
Find_Me	ÕÒÎÒ
Sein	Sein
¿ñÏ²ÌmÎè1	¿ñÏ²1
¿ñÏ²ÌmÎè2	¿ñÏ²2
Sparkle New Life	ÉÁÁÁÐÂÉú»î
Khronostasis Katharsis	KK
Geopelia 1 -by cycats	cycats_1
Geopelia 2 -by cycats	cycats_2
Engine x Start!! extra 1 -by cycats	cycats_3
FULi AUTO SHOOTER extra 1 -by cycats	cycats_4
Non-Melodic Ragez extra 1 -by cycats	cycats_5
RIPPER extra 1 -by cycats	cycats_6
RIPPER extra 2 -by ºÎºÇ	ºÎºÇ1
Marenol extra 1 -by ß÷n¿û	ß÷n¿û mopenol
ÔÆÅ®º¢ extra 1 -by ÓùÛà¹û×Ó	ÓùÛà¹û×ÓÔÆÅ®º¢
Geopelia in WEPLAY -by º£²ú	Geopelia in WEPLAY
Geopelia 3 -by ºÎºÇ	ð¯ »ÕÕÂ
Christmas -2019	Ê¥µ®½Ú-2019
Snow Desert	Snow Desert
Burn	Burn
FeastÔ¶¶«Ö®Ñç1	Feast1
FeastÔ¶¶«Ö®Ñç2	Feast2
FeastÔ¶¶«Ö®Ñç3	Feast3
FeastÔ¶¶«Ö®Ñç4	Feast4
FeastÔ¶¶«Ö®Ñç5	Feast5
FeastÔ¶¶«Ö®Ñç6	Feast6
FeastÔ¶¶«Ö®Ñç7	Feast7
FeastÔ¶¶«Ö®Ñç8	Feast8
FeastÔ¶¶«Ö®Ñç9	Feast9
´ÉËê1	´ÉËê1
´ÉËê2	´ÉËê2
´ÉËê3	´ÉËê3
´ÉËê4	´ÉËê4
´ÉËê5	´ÉËê5
´ÉËê6	´ÉËê6
´ÉËê7	´ÉËê7
ÕµÜø1	ÕµÜø1
ÕµÜø2	ÕµÜø2
ÕµÜø3	ÕµÜø3
ÇàÑ¿	ÇàÑ¿
FeastÔ¶¶«Ö®Ñç-Special1	FeastÌØµä1
FeastÔ¶¶«Ö®Ñç-Special2	FeastÌØµä2
´ÉËê-Special	´ÉËêÌØµä
ÕµÜø-Special	ÕµÜøÌØµä
ÇàÑ¿-Special	ÇàÑ¿ÌØµä
